S1111111
55555551
11111551
1##11551
1##11551
11111551
5555555G
11111111